1111111111
1P0C0X00C1
1E0010C001
1111111111