11111111111111111111111111111111111111111
1P0001110000C000110010101000C000001C00001
10000000000000000000000000000000000000001
11111111111111111111111110000001100000001
100000000C0000000000001111100000000000001
1C000111111111110000000000000000000C11111
10000000000011111111111111100000000000001
10000000000000000000000000000000000000001
10000000000000000000000000000000000000001
11111111111000000000000000000000000000001
100000000000000000000C0000000000000000001
10000000000000000000000000000011111111111
10000000000C00000000000000000000000000001
10000000000000000111111111000000000000001
10000000000000000000000000000000000000001
101111111000000000000C0000000000000000001
10000000000000000000000000000001111110001
10000000000000C00000000000000000000000001
11111100000000000000001111111100000C11111
10000000001111000001100000000000000000011
1E0010C111111100000C0000111111C00000000C1
11111111111111111111111111111111111111111