11111111
1P0C00C1
1E0010C1
11111111