1111111111
1P10C01101
10001000C1
11C0111001
111000C001
1000000001
1111110001
100000СС01
1EC0000001
1111111111